111111
1P0C01
10C0E1
111111
