11111111111111111111
1P0000C00000000000E1
11111111111111111111
