11111111111111
1P000000C000E1
1000C000000001
11111111111111
