11111111111111111111
1001000000010C000001
1011011111C100001111
10000000010111011001
10011111010010000001
1P010000010010111101
10010010010110000E01
10000010C10001111101
11110010010100000001
10000010000111001001
11111111111111111111
