1111111111111111111
1001000000010C00001
1011011111C10000111
1000000001011110101
1001111101001000001
1P01000001001011111
1001001001011000001
10000010C1000011101
11110010010100000E1
1111111111111111111
