111111111111111111111
1001000000100C100C001
100110111010001011101
101100001000100001001
100101001111111100001
1001C1000000100000101
100101101111100010101
10000010C1C0101110111
100010000100101000101
101110111100101E11101
10C100000000000P00001
111111111111111111111
