111111111111111111111
1000000000C000100C001
101111011111011111101
1C10000C0010000000101
111011111011110110101
100010000010000010001
101C10110111011010101
1010101000C000101C101
101000001101101000101
101111101001000010101
10C000001011P01E10001
111111111111111111111
