111111111111111111111
1000000000C000000C001
1001000001000000001C1
1C01000C01000C0000101
100100000000000000101
10010010C000111110001
100C00100000000000001
1000001000C000000C001
100000100000000000001
100100000111110000001
10C100000000P00E000C1
100100000000000100C01
10010011111000010C001
100100000000000100001
10000000C000000C00001
100000000000000000001
111111111111111111111
